1111111111111111
1000M00CE00000C1
100P000000000C01
1111111111111111
