1111111111111111
1000M00CE00000C1



1000P00000000C01
1111111111111111