11111111
000PEC01
10000C01
11111111